###############################################################################
###U###########################################################################
#*****************************************************************************#
#*****************************************************************************#
#*****************************************************************************#
#*****************************************************************************#
#*****************************************************************************#
#*********************************************************O*******************#
#******************************z**********************************************#
#*****************************************************************************#
#**********O******************************************************************#
#*****************************************************************************#
#***********************************O*****************************************#
#******************************#####*####*************************************#
#******************************#********#************z***********z************#
#******************************#****B***#*************************************#
#******************************#********#*************************************#
#*****************z************##########*************************************#
#*****************************************************************************#
#*****************************************************************************#
#*****************************************************************************#
#*****************************************************************************#
#*****************************************************************************#
#*****************************************************************************#
#**********************************************************Z******************#
#***************************O*************************************************#
#*****************************************************************************#
#*****************************************************************************#
#************L*************************************************O**************#
#*****************************************************************************#
########################################################################I######